Participant,error,Unusual Experiences,Cognitive Disorganisation,Introvertive Anhedonia,Impulsive Nonconformity,O-life,Confidence,Average_RT
D02,0.1,3,3,4,1,11,9.8,2.9593255
D04,5.6,3,3,1,2,9,7.2,0.836831
D08,3.9,7,7,4,7,25,7.8,0.77478
D10,7,4,8,6,0,18,9.2,0.648728
D12,0.8,4,5,6,2,17,8,0.3897125
D14,1.4,5,5,4,4,18,9.8,0.7571435
D16,1,7,10,1,3,21,8.6,0.5512165
D18,0.2,4,4,3,4,15,8.9,0.2081605
D20,0.4,4,3,0,1,8,10,0.578216
D21,1.1,5,11,7,9,32,9.6,0.934158
