Participant,score,Unusual Experiences,Cognitive Disorganisation,Introvertive Anhedonia,Impulsive Nonconformity,O-Life,Confidence
D02,0.3,3,3,4,1,11,9.8
D04,13.7,3,3,1,2,9,7.2
D08,16.1,7,7,4,7,25,7.8
D10,13,4,8,6,0,18,9.2
D12,18.1,4,5,6,2,17,8
D14,18.4,5,5,4,4,18,9.8
D16,19,7,10,1,3,21,8.6
D18,19.8,4,4,3,4,15,8.9
D20,19.3,4,3,0,1,8,10
D21,15.9,5,11,7,9,32,9.6
